                                                           ##########
                                    ############           #........>
                                    #..........#           #{########
                                    #..........#           #......#
                                    #.....?....#           #*.....#
                       ##############..........########### @~=~~~.#
                       #....,.......]..........[.........# @~=~~~.#
                      ##....,....#######################.# @~=~~~.#
                     ##~~~..*..~~~##                   #.# #......#
##@#@#@#@###        ##~~~~~~=~~~~~~##         ##########.###..#####
#~~~~~~~~~~#       ##~~~~~~~=~~~~~~~##        #~~~~~~~~~......#
#~~~~~~~~~~#########~~~~~~~.k.~~~~~~~##########~~~~~~~~~~~~~..#
#~~~~~~~~~*.........,,,,~~~.?.~~~,,,,{...........?.....~~~~~?.#
#~,~,~,~,~~#########~~~=~~~...~~~=~~~##########~~~~~~~.~~~~~..#
#########~##       ##~~=~~~~~~~~~=~~##        #..?.....~~~~~=~#
                    ##...+~~~~~+...##         #.~~~~~~~~~~~~=~#
                     ##...........##          #..?....*~~~~~..#
                      ##.........##           #~~~~~~~~~~~~~..#
                       ##.......##            ##############..#
                        ###...###                    #........#
                          #.,.#                      #.######## 
                        ###...###                    #.#
        #######         #...,...#                    #.#
    #####.....#         #.+...+.#      ###############.#
    #...#.....###########...,...########.............#.#
    #.k.]..?..[............,.,.......................[.#
    #...#.....###########...,...########...*.*.*.*...###
    #####.....#         #.+...+.#      #.............#
        #######         #...,...#      ###############
                        #.+...+.#
                        #...,...#
                        ####[####
                           #.# 