                                                           ##########
                                     ###########           #........>
                          ############+........#           #{########
                          #..........].........#           #......#
                          #...########+....?...#           #*.....#
                        ###...###    #.........########### @~=~~~.#
                       ##...,...##   #.........[.........# @~=~~~.#
                      ##....,....##  ###################.# @~=~~~.#
                     ##~~~..*..~~~##                   #.# #......#
##@#@#@#@###        ##~~~~~~=~~~~~~##         ##########.###..#####
#~,~,~,~,~~#       ##~~~~~~~=~~~~~~~##        #~~~~~~~~~......#
#~~~~~~~~~~#########~~~~~~~.k.~~~~~~~##########~~~~~~~~~~~~~..#
#~~~~~~~~~*.........,,,,~~~.?.~~~,,,,{...........?.....~~~~~?.#
#~+~+~+~+~~#########~~~=~~~...~~~=~~~##########~~~~~~~.~~~~~..#
############       ##~~=~~~~~~~~~=~~##        #..?.....~~~~~=~#
                    ##...+~~~~~+...##         #.~~~~~~~~~~~~=~#
                     ##...........##          #..?....*~~~~~..#
                      ##.........##           #~~~~~~~~~~~~~..#
                       ##...,...##            ##############..#
                        ###...###                    #........#
                          #.,.#                      #.########
                        ###...###                    #.#
      #########         #...,...#                    #.#
  #####.......#         #.+...+.#      ###############.#
  #...#+......###########...,...########......+......#.#
  #.k.]....?..[..........,.,.,.,.....................[.#
  #...#+......###########...,...########...*.*.*.*...###
  #####.......#         #.+...+.#      #.............#
      #########         #...,...#      ###############
                        #.+...+.#
                        #...,...#
                        ####[####
                           #.#