                                                                    ##########
                                                                    #........>
                                             ###########            #{########
                                             #.........#            #......#
                                             #.........#            #*.....#
                                ##############....?....############ @~=~~~.#
                                #....,.......].........[..........# @~=~~~.#
                               ##....,....#######################.# @~=~~~.#
                              ##~~~..*..~~~##                   #.# @......#
          #@@@@@@@###        ##~~~~~~=~~~~~~##         ##########.###..#####
          #~~~~~~~~~#       ##~~~~~~~=~~~~~~~##        #~~~~~~~~~......#
          #~~~~~~~~~#########~~~~~~~.k.~~~~~~~##########~~~~~~~~~~~~~..#
          #~~~~~~............,,,,~~~.?.~~~,,,,{...........?.....~~~~~?.#
          #~~~~~~.~~#########~~~=~~~...~~~=~~~##########~~~~~~~.~~~~~..#
        ###~~~~~..~~#       ##~~=~~~~~~~~~=~~##        #..?.....~~~~~=~#
        #.]*******~~#        ##...+~~~~~+...##         #.~~~~~~~~~~~~=~#
        #.#+++++++~~#         ##...........##          #..?....*~~~~~..#
 ########.###########          ##...###...##           #~~~~~~~~~~~~~..#
 #@~@~@~@*#                     ##.......##            ##############..#
 #~~~~~~~~#                      ###...###                    #........#
 #,~,~,~,~#                        #.,.#                      #.########
 ##########                      ###...###                    #.#
                 #######         #...,...#                    #.#
             #####.....#         #.+...+.#      ###############.#
             #...#.....###########...,...########.............#.#
             #.k.]..?..[............,.,.......................[.#
             #...#.....###########...,...########...*.*.*.*...###
             #####.....#         #.+...+.#      #.............#
                 #######         #...,...#      ###############
                                 #.+...+.#
                                 #...,...#
                                 ####[####
                                    #.#