


         
            ######## ##~~~~~~~=~~~~~~~##  
            #@@@@@@###~~~~~~~.k.~~~~~~~###
            #~~~~~........~~~.?.~~~....{..
            #~~~~~.###~~~=~~~...~~~=~~~###
          ###~~~~~.# ##~~=~~~~~~~~~=~~##
          #.]******#  ##...+~~~~~+...##
          #.#++++++#   ##...........##
   ########.########    ##...###...##
   #@~@~@~@*#            ##.......##
   #~~~~~~~~#             ###...###
   #,~,~,~,~#               #...#
   ##########             ###...###
                 #######  #...,...#
                 #.....#  #.+.,.+.################
              ####.....####...,...#..............#
              #..]..?..[....,,,,,....*..*..*..*..[
              #k.#.....####...,...#..............#
              ####.....#  #.+.,.+.################
                 #######  #...,...#
                          #.+.,.+.#
                          #...,...#
                          ####U####