                                                           ##########
                                     ###########           #........>
                          ############.........#           #{########
                          #..........].........#           #......#
                          #...########.....?...#           #*.....#
                        ###...###    #.........########### @~=~~~.#
                       ##...,...##   #.........[.........# @~=~~~.#
                      ##....,....##  ###################.# @~=~~~.#
                     ##~~~..*..~~~##                   #.# #......#
##@#@#@#@###        ##~~~~~~=~~~~~~##         ##########.###..#####
#~,~,~,~,~~#       ##~~~~~~~=~~~~~~~##        #~~~~~~~~~......#
#~~~~~~~~~~#########~~~~~~~.k.~~~~~~~##########~~~~~~~~~~~~~..#
#~~~~~~~~~*.........,,,,~~~.?.~~~,,,,{...........?.....~~~~~?.#
#~+~+~+~+~~#########~~~=~~~...~~~=~~~##########~~~~~~~.~~~~~..#
############       ##~~=~~~~~~~~~=~~##        #..?.....~~~~~=~#
                    ##...+~~~~~+...##         #.~~~~~~~~~~~~=~#
                     ##...........##          #..?....*~~~~~..#
                      ##.........##           #~~~~~~~~~~~~~..#
                       ##...,...##            ##############..#
                        ###...###                    #........#
                          #.,.#                      #.######## 
                        ###...###                    #.#
        #######         #...,...#                    #.#
    #####.....#         #.+...+.#      ###############.#
    #...#.....###########...,...########.............#.#
    #.k.]..?..[..........,.,.,.,.....................[.#
    #...#.....###########...,...########...*.*.*.*...###
    #####.....#         #.+...+.#      #.............#
        #######         #...,...#      ###############
                        #.+...+.#
                        #...,...#
                        ####[####
                           #.# 