                                            ############################
                                            <..........................#
                                            ##########################{####
                                              #.........#            #......#
                                              #.........#            #*.....#
                                 ##############....?....############ @~=~~~.#
                                 #....,.......].........[..........# @~=~~~.#
                                ##....,....#######################.# @~=~~~.#
                               ##~~~..*..~~~##                   #.# @......#
                              ##~~~~~~=~~~~~~##         ##########.###..#####
                             ##~~~~~~~=~~~~~~~##        #~~~~~~~~~......#
          #@@@@@@#############~~~~~~~.k.~~~~~~~##########~~~~~~~~~~~~~..#
          #~~~~~..............,,,,~~~.?.~~~,,,,{...........?.....~~~~~?.#
          #~~~~~.#############~~~=~~~...~~~=~~~##########~~~~~~~.~~~~~..#
        ###~~~~~.#           ##~~=~~~~~~~~~=~~##        #..?.....~~~~~=~#
        #.]******#            ##...+~~~~~+...##         #.~~~~~~~~~~~~=~#
        #.#++++++#             ##...........##          #..?....*~~~~~..#
 ########.########              ##...###...##           #~~~~~~~~~~~~~..#
 #@~@~@~@*#                      ##.......##            ##############..#
 #~~~~~~~~#                       ###...###                    #........#
 #,~,~,~,~#                         #.,.#                      #.########
 ##########                       ###...###                    #.#
                  #######         #...,...#                    #.#
              #####.....#         #.+...+.#      ###############.#
              #...#.....###########...,...########.............#.#
              #.k.]..?..[............,.,.............*.*.*.*...[.#
              #...#.....###########...,...########.............###
              #####.....#         #.+...+.#      ###############
                  #######         #...,...#
                                  #.+...+.#
                                  #...,...#
                                  ####[####
                                     #.#