                 ######################################
                 <....................................#
                 ####################################{####
                                    #.........#   #......#
                                    #.........#   #*.....#
                       ##############....?....### @~=~~~.#
                       #....,.......].........[.# @~=~~~.#
                      ##....,....##############.# @~=~~~.#
                     ##~~~..*..~~~##          #.# @......#
                    ##~~~~~~=~~~~~~##  ########.###..#####
          ######## ##~~~~~~~=~~~~~~~## #~~~~~~~......#
          #@@@@@@###~~~~~~~.k.~~~~~~~###~~~~~~~~~~~..#
          #~~~~~....,,,,~~~.?.~~~,,,,{....?.....~~~?.#
          #~~~~~.###~~~=~~~...~~~=~~~###~~~~~~~.~~~..#
        ###~~~~~.# ##~~=~~~~~~~~~=~~## #..?.....~~~=.#
        #.]******#  ##...+~~~~~+...##  #.~~~~~~~~~~=.#
        #.#++++++#   ##...........##   #..?....*~~~..#
 ########.########    ##...###...##    #~~~~~~~~~~~..#
 #@~@~@~@*#            ##.......##     ############..#
 #~~~~~~~~#             ###...###              #.....#
 #,~,~,~,~#               #...#                #.#####
 ##########             ###...###              #.#
               #######  #...,...#              #.#
               #.....#  #.+.,.+.################.#
            ####.....####...,...#..............#.#
            #..]..?..[....,,,,,....*..*..*..*..[.#
            #k.#.....####...,...#..............###
            ####.....#  #.+.,.+.################
               #######  #...,...#
                        #.+.,.+.#
                        #...,...#
                        ####[####
                           #.#