,,,,,,,,,,,,,,,,,,,,,,,,,,,,,,,,,,,,,
.....................................
..#...#..........#........##...##....
...#.#...........#.......#....#......
....#...###.#.#..#...###..##..##.....
....#...#.#.#.#..#...#.#....#.#......
....#...###.###..###.###..##...##.#..
.....................................
,,,,,,,,,,,,,,,,,,,,,,,,,,,,,,,,,,,,,