#####
#~~~######  ########
#..~.....#  #...*..#
#..~.....####......#
#..=..P............#
#..~.....#######.###
##########     #[#
               #.#
   #############.##
   #..#......#+..+######
   #k.]...?..[....{...>#
   #..#......#....######
   ###########+..+#
             ######