#####
#~~~######  ########
#..~.....#  #...*..#
#..~.....####......#
#..=..P............#
#..~.....#######.###
##########     #[#
               #.#
   #############.##
   #..#......#+..+#####
   #k.]...?..[....{...>
   #..#......#....#####
   ###########+..+#
             ######