#####
#~~~######  ########
#........#  #......#
#........####...*..#
#.....P............#
#........#######.###
##########     #[#
               #.#
   #############.##
   #..#......#+..+######
   #k.]...?..[....{....#
   #..#......#....######
   ###########+..+#
             ######