#####
#~~~######  ########
#........#  #...*..#
#........####......#
#.....P............#
#........#######.###
##########     #[#
               #.#
   #############.##
   #..#......#+..+######
   #k.]...?..[....{....#
   #..#......#....######
   ###########+..+#
             ######