,,,,,,,,,,,,,,,,,,,,,,,,,,,,,,,,,,,,,
.....................................
...#...#..................#.....#....
....#.#...........#.....#.......#....
.....#...###.#.#..#..#..#.#..#..#....
.....#...#.#.#.#..#..#..#.#.#.#......
.....#...###.###...##.##..#.#.#.#....
.....................................
,,,,,,,,,,,,,,,,,,,,,,,,,,,,,,,,,,,,,