




						#...#
                      ###...###
             #######  #...,...#
             #.....#  #.+.,.+.#############
          ####.....####...,...#...........#
          #..].....[...,,,,,,,...*..*..*..[
          #k.#.....####...,...#...........#
          ####.....#  #.+.,.+.#############
             #######  #...,...#
                      #.+.,.+.#
                      #...,...#
                      ####U####