#####
#~~~######  ########
#........#  #......#
#........####...k..#
#.....P............#
#........#######.###
##########     #.#
               #.#
             ###.##
        ######+..+#
        #....{....#
        #....{....#
        ######+..+#
             ######