#####
#~~~######  ########
#........#  #......#
#........####......#
#..................#
#........#######.###
##########     #.#
               #P#
               ###