#####
#~~~######  ########
#........#  #......#
#........####...*..#
#.....P............#
#........#######.###
##########     #[#
               #.#
        ########.##
      ###...##+..+######
      #k]...[.....{....#
      ###...##....######
        ######+..+#
             ######