#####
#~~~######  ########
#........#  #......#
#........####...k..#
#.....P............#
#........#######.###
##########     #[#
               #.#
             ###.##
        ######+..+#
        #....[....#
        ######....#
             #+..+#
             ######